{
  "rows": 20,
  "columns": 20,
  "tileSize": 64,
  "tiles": [
    "01111111111111111111",
    "11100000001110000001",
    "10000010000001111111",
    "10000000000000000001",
    "10000000000000000001",
    "10000000000000000001",
    "10000000000000000001",
    "11111111000000000001",
    "10000000000000000001",
    "10000000000000000001",
    "10000000001111111111",
    "10000000000000000001",
    "10000000000000000001",
    "10000000000000000001",
    "11111110000011111111",
    "10000000000000000001",
    "10000000000000000001",
    "10000000000000000001",
    "10000000000000000001",
    "11111111111111111111"
  ]
}