{
  "rows": 20,
  "columns": 20,
  "tileSize": 64,
  "tiles": [
    "11111111111111111111",
    "11111111111111111111",
    "11101111111111111011",
    "11111111111111111111",
    "11111111111111111111",
    "11111111111111111111",
    "11111111111111111111",
    "11111111111111111111",
    "11111111111111111111",
    "11111111111111111111",
    "11111111111111111111",
    "11111111111111111111",
    "11111111111111111111",
    "11111111111111111111",
    "11111111111111111111",
    "11111111111111111111",
    "11111111111111111111",
    "11101111111111110111",
    "11111111111111111111",
    "11111111111111111111"
  ]
}