{
  "rows": 5,
  "columns": 20,
  "tileSize": 64,
  "tiles": [
    "10101010101010101001",
    "10101010101010101001",
    "10101010101010101001",
    "11101010101010101001",
    "10101010101010101001"
  ]
}