{
  "rows": 15,
  "columns": 20,
  "tileSize": 64,
  "tiles": [
    "11111111111111111111",
    "11111111111111111111",
    "11111111111111111111",
    "21111111111111111111",
    "11111111111111111111",
    "11111111111111111111",
    "11111111111111111111",
    "11111111111111111111",
    "11111111111111111111",
    "11111111111111111111",
    "11111111111111111111",
    "11111111111111111113",
    "11111111111111111111",
    "11111111111111111111",
    "11111111111111111111"
  ]
}